********WTTW********
*****WWWWTTWWWW*****
*****WTTTTTTTTW*****
*****WTHHHHHHTW*****
*****WTHHTTHHTW*****
*****WTHHTTHHTW*****
*****WTHHHHHHTW*****
*****WTTHHHHTTW*****
*****WWWWWWWWWW*****
********************
********************
********************
********************
********************
********************
********************
********************
********************
********************
********************

