********WTTW********
*****WWWWTTWWWW*****
*****WTTTTTTTTW*****
*****WTTTTTTTTW*****
*****WTTTTTTTTW*****
*****WTTTTTTTTW*****
*****WTTTTTTTTW*****
*****WTTTTTTTTW*****
*****WWWWWWWWWW*****
********************
********************
********************
********************
********************
********************
********************
********************
********************
********************
********************

