********WTTW********
*****WWWWTTWWWW*****
*****WTTTTTTTTW*****
*****WTTTTTTTTW*****
*****WTTTTTTTTW*****
*****WTTTTTTTTW*****
*****WWWWTTWWWW*****
********WTTW********
******WWWTTWWW******
******WWTTTTTW******
******WTTTTTWW******
******WWTTTTTW******
******WTTTTTWW******
*****WWWWTTWWWW*****
*****WTTTTTTTTW*****
*****WTTTTTTTTW*****
*****WTTTTTTTTW*****
*****WTTTTTTTTW*****
*****WWWWTTWWWW*****
********WTTW********

