WWWWWWWWWTTWWWWWWWWW
WTTTTTTTTTTTTTTTTTTW
WTTTTTTTTTTTTTTTTTTW
WTTTTTTTTTTTTTTTTTTW
WTTTTTTTTTTTTTTTTTTW
WTTTTTTTTTTTTTTTTTTW
WTTTTTTTTTTTTTTTTTTW
WTTTTTTTTTTTTTTTTTTW
WTTTTTTTTTTTTTTTTTTW
WTTTTTTTTTTTTTTTTTTW
WTTTTTTTTTTTTTTTTTTW
WTTTTTTTTTTTTTTTTTTW
WTTTTTTTTTTTTTTTTTTW
WTTTTTTTTTTTTTTTTTTW
WTTTTTTTTTTTTTTTTTTW
WTTTTTTTTTTTTTTTTTTW
WTTTTTTTTTTTTTTTTTTW
WTTTTTTTTTTTTTTTTTTW
WTTTTTTTTTTTTTTTTTTW
WWWWWWWWWWWWWWWWWWWW
