********WTTW********
*****WWWWTTWWWW*****
*****WTTTTTTTTW*****
*****WTTTTTTTTW*****
*****WTTTTTTTTW*****
*****WTTTTTTTTW*****
*****WWWWTTWWWW*****
********WTTW********
WWWW**WWWTTWWWWWWWWW
TTTWW*WWTTTTTTTTWWTT
TTTTWWWTTTTTWTWTTTTT
WWTTTTTWTTTTTWWWWWWW
*WWTTTTTTTTTWW******
**WWWWWWWTTWWWW*****
*****WTTTTTTTTW*****
*****WTTTTTTTTW*****
*****WTTTTTTTTW*****
*****WTTTTTTTTW*****
*****WWWWTTWWWW*****
********WTTW********

