********WTTW********
*****WWWWTTWWWW*****
*****WTTTTTTTTW*****
*****WTTTTTTTTW*****
*****WTTTTTTTTW*****
*****WTTTTTTTTW*****
*****WWWWTTWWWW*****
********WTTW***WWWW*
******WWWTTWWWWWTTWW
******WWTTTTTTTTTTTT
******WTTTTTTTTTTTTT
******WTTTTTTTTTWWWW
******WTTTTTTTTTW***
******WTTTTTTTTTW***
******WWWTTTTTWWW***
********WWWTTWW*****
**********WWWW******
********************
********************
********************

