WWWWWWWWWTTWWWWWWWWW
WTTTTTTTTTTTTTTTTTTW
WTTTTTTTTTTTTTTTTTTW
WTTTTTTTTTTTTTTTTTTW
WTTTTTTTTTTTTTTTTTTW
WTTTTTTTTTTTTTTTTTTW
WTTTTTTTTTTTTTTTTTTW
WTTTTTTTTTTTTTTTTTTW
WTTTTTTTTTTTTTTTTTTW
TTTTTTTTTTTTTTTTTTTT
TTTTTTTTTTTTTTTTTTTT
WTTTTTTTTTTTTTTTTTTW
WTTTTTTTTTTTTTTTTTTW
WTTTTTTTTTTTTTTTTTTW
WTTTTTTTTTTTTTTTTTTW
WTTTTTTTTTTTTTTTTTTW
WTTTTTTTTTTTTTTTTTTW
WTTTTTTTTTTTTTTTTTTW
WTTTTTTTTTTTTTTTTTTW
WWWWWWWWWTTWWWWWWWWW
