WWWWWWWWWTTWWWWWWWWW
WTTTTTTTTTTTTTTTTTTW
WTTTTTTTTTTTTTTTTTTW
WTTTTTTTTTTTTTTTTTTW
WTTTTTTTTTTTTTTTTTTW
WTTTTTTTTTTTTTTTTTTW
WTTTTTTTTTTTTTTTTTTW
WTTTTTTTTTTTTTTTTTTW
WTTTTTTTTTTTTTTTTTTW
WTTTTTTTTTTTTTTTTTTT
WTTTTTTTTTTTTTTTTTTT
WTTTTTTTTTTTTTTTTTTW
WTTTTTTTTTTTTTTTTTTW
WTTTTTTTTTTTTTTTTTTW
WTTTTTTTTTTTTTTTTTTW
WTTTTTTTTTTTTTTTTTTW
WTTTTTTTTTTTTTTTTTTW
WTTTTTTTTTTTTTTTTTTW
WTTTTTTTTTTTTTTTTTTW
WWWWWWWWWWWWWWWWWWWW
