WWWWWWWWWWWWWWWWWWWW
WTTTTTTTTTTTTTTTTTTW
WTTTTTTTTTTTTTTTTTTW
WTTTTTTTTTTTTTTTTTTW
WTTTTTTTTTTTTTTTTTTW
WTTTTTTTTTTTTTTTTTTW
WTTTTTTTTTTTTTTTTTTW
WTTTTTTTTTTTTTTTTTTW
WTTTTTTTTTTTTTTTTTTW
WTTTTTTTTTTTTTTTTTTW
WTTTTTTTTTTTTTTTTTTW
WTTTTTTTTWWTTTTTTTTW
WTTTTTTTTWWTTTTTTTTW
WTTTTTTTTTTTTTTTTTTW
WTTTTTTTTTTTTTTTTTTW
WTTTTWWTTTTTTWWTTTTW
WTTTTWWTTTTTTWWTTTTW
WTTTTTTTTTTTTTTTTTTW
WTTTTTTTTTTTTTTTTTTW
WWWWWWWWWWWWWWWWWWWW
