WWWWWWWWWTTWWWWWWWWW
WWWTTTTTTTTTTTTTTWWW
WWTTTTTTTTTTTTTTTTWW
WTTTTWWWWTTTTTTTTTTW
WTTTTTWWWWTTTTTTTTTW
WTTTTTTwWTTTTTWWTTTW
WTTTTTTTTTTTTWWWWTTW
WTTTTTTTTTTTTTTTTTTW
WTTTTTTWWTTTTTTTTTTW
WTTTTTTwWWWWTTTTTTTW
WTTTTTTTTWWTTTTTTTTT
WTTTTTTTTWWTTTTTTTTT
WTTTTTTTWWWTTTTTTTTW
WTTTTTWWWWTTTTTTTTTW
WTTTTTTTWWWTTTTTTTTW
WTTTTWWTTTTTTTWTTTTW
WTTTWWTTTTTTWWWTTTTW
WWTWWTTTTTTTTTWTTTWW
WWWTTTTTTTTTTTTTTWWW
WWWWWWWWWWWWWWWWWWWW

